NO ./resources/textures/Bricks007_2K-JPG_Color.xpm
SO ./resources/textures/Plaster001_2K-JPG_Color.xpm
WE ./resources/textures/Tiles045_2K-JPG_Color.xpm
EA ./resources/textures/Wood003_2K-JPG_Color.xpm


F 220,100,0
C 225,30,0

1111111111111111111111111
1000000000110100000000001
1011000001110010010000001
1001000000000001100000001
101100000111000000000N001
1111111111111111111111111