NO ./resources/textures/Bricks007_2K-JPG_Color.xpm
SO ./resources/textures/Plaster001_2K-JPG_Color.jpg
WE ./resources/textures/Tiles045_2K-JPG_Color.jpg
EA ./resources/textures/Wood003_2K-JPG_Color.jpg

F 220,100,0
C 225,30,0

111111111111111111111111111111111111111111111
111000000000000000000000000000000000000011111
111000000000000000000000000000000000000001111
110000000000000000000000000000000000000000011
100000000000000000000000000000000000000000011
111111100000000000000000000000000000000000111
110000000000000000000000000000000000000001111
100000000000000000000000000000000000000000111
100000000000000000000000000000000000000000001
11111110000000000000000000000000000000000W111
110000000000000000000000000000000000000001111
100000000000000000000000000000000000000000111
100000000000000000000000000000000000000000001
111111100000000000000000000000000000000000111
110000000000000000000000000000000000000001111
100000000000000000000000000000000000000000111
100000000000000000000000000000000000000000001
111111100000000000000000000000000000000000111
110000000000000000000000000000000000000001111
100000000000000000000000000000000000000000111
100000000000000000000000000000000000000000001
111111111111111111111111111111111111111111111
