NO ./resources/textures/Bricks007_2K-JPG_Color.xpm
SO ./resources/textures/Plaster001_2K-JPG_Color.jpg
WE ./resources/textures/Tiles045_2K-JPG_Color.jpg
EA ./resources/textures/Wood003_2K-JPG_Color.jpg

F 220,100,0
C 225,30,0

111111111111
111000011111
111000001111
110000000011
100000000011
11111110W111
110000001111
100000000111
100000000001
111111111111
