  NO    	 ./resources/textures/Bricks007_2K-JPG_Color.xpm




        SO     ./resources/textures/Plaster001_2K-JPG_Color.xpm



WE       ./resources/textures/Tiles045_2K-JPG_Color.xpm C 225,30,0



EA ./resources/textures/Wood003_2K-JPG_Color.xpm

	F 220,100,0


        111111111111111111111111
        1000000000110000000000001
        101100000111000000000N001
        1001000000000000000000001
111111111011000001110000000000001
100000000011000001110111111111111
11110111111111011100000010001
11110111111111011101010010001
11000000110101011100000000001
10000000000000001100000010001
10000000000000001101010010001
1100000111010101111101111000111
11110111 1110101 101111010001
11111111 1111111 111111111111
