NO ./resources/textures/Bricks007_2K-JPG_Color.xpm
SO ./resources/textures/Plaster001_2K-JPG_Color.xpm
WE ./resources/textures/Tiles045_2K-JPG_Color.xpm
EA ./resources/textures/Wood003_2K-JPG_Color.xpm

F 220,100,0
C 225,30,0

1111111111111111111111111111111
1110000000000000000000000011111
1110000000000000000000000001111
1100000000000000000000000000011
1111111000000000000000000000111
1100000000000000000000000001111
1111111000000000000000011111111
111111100000000N000000000001111
1111111000000000000000000000111
1100000000000000000000000001111
1111111000000000000000000000111
1100000000000000000000000001111
1111111111111111111111111111111
