NO ./resources/textures/Bricks007_2K-JPG_Color.xpm


SO ./resources/textures/Plaster001_2K-JPG_Color.xpm



WE ./resources/textures/Tiles045_2K-JPG_Color.xpm


EA ./resources/textures/Wood003_2K-JPG_Color.xpm


F 220,100,0

C 225,30,0





        1111111111111111111111111
        1000000000110000000000001
        1011000001110000000000001
        1001000000000000000000001
11111111101100000111000000000000100
100000000011000001110111111111111
111101111111110111000000100010000
111101111111110111010100100011
110000001101010111000000000001100000
100000000000000011000000100011
10000000000000001101010010001
11000001110101011111011111N1111
11110111 1110101 101111010101
11111111 1111111 111111111111
