NO ./resources/textures/Bricks007_2K-JPG_Color.xpm
SO ./resources/textures/Plaster001_2K-JPG_Color.xpm
WE ./resources/textures/Tiles045_2K-JPG_Color.xpm
EA ./resources/textures/Wood003_2K-JPG_Color.xpm


F 220,100,0
C 225,30,0

        111111111111
        100000000011
        10110S000111
        100100000010
11111111101101100111
10000000001100100111
1111111111111111111
